4444444444444444
4555555555555554
4555555555555554
4555555555555554
4444444555555554
4555554555555555
4555555555555554
4444444555555554
4555555555555554
4555555555555554
4555555555555554
4444444444444444