4444444444444444
4555555555555554
4555555555555554
4555555555555554
4555555555555554
4555555555555557
4555555555555554
4555555555555554
4555555555555554
4555555555555554
4555555555555554
4444444444444444