0000000000000000
0111111111111110
0111111111111110
0111100000011110
0111101111111110
0111101000011110
0111101011111110
0111101011111110
0111111111111110
0111111111111110
0111111111111110
0000000000000000