0000000100000000
0111111111111110
0111111111111110
0111111111111110
0111111111111110
6111111111111111
0111333323331110
0111322222231110
0111322222231110
0111322222231110
0111333333331110
0000000000000000