6666666666666666
6777777777777776
6777777777777776
6777777777777776
6777777777777776
6777777777777776
6777777777777776
6777777777777776
6777777777777776
6777777777777776
6777777777777776
6666666766666666