8888888888888888
8999999999999998
8999999999999998
8999999999999998
8888888888888888
8999999999999998
8999999999999998
8999999999999998
8999999999999998
8999999999999998
8999999999999998
8888888988888888