6666666666666666
6777777777777776
6777777777777776
6777777777666666
6777777777677776
7777777777777776
6777777777677776
6777777777666666
6777777777777776
6777777777777776
6777777777777776
6666666666666666